###########################################
#  F    F           #                     #
# #                 #   R                 #
#             # # # #      #               
#          #     ##                       #
#   ####                #                 #
###############       #####################