###########################################
#  F    F           #                     #
# #                 #   R                 #
#             # # # #      #               
# R        #     ##                       #
#   #### C              #                 #
###########################################