###########################################
#  F    F           #                     #
# #                 #   R                 #
#             # # # #      #               
# R        #     ##                       #
#   ####                #                 #
###########################################